NO ./texture/totoro_no.png
SO ./texture/totoro_so.png
WE ./texture/totoro_we.png
EA ./texture/totoro_ea.png

F 253,108,158
C 253,108,1

111111111111111111111111
10000000000000000000000011
10000100000000000000000001
1000101000000000000000011 
100001000000100001000N001
10000000000000001 1000001
1011111111111111 10111111
111               1


                 


